###########################
***************************
***************************
***************************
***************************
***************************
***************************
***************************
********##************##***
*##*************###********
***************************
*****#****####*******0*****
*********************#*****
**##************##*********
********####***************
***************************
***###********##*****##****
***********0***************
*********####*****##*******
***************************
******##*************##****
**@**000**************0****
###########################
